+-----------------------------------+
|@                                  |
|     |                             |
|     |           |--------|    |   |
|     |--------- -|        |    |   |
|     |           |        |----|   |
|                 |        |        |
|         --------|                 |
|                                   |
+-----------------------------------+