+-----------------------------------+
|@                                  |
|  |-----------------------------|  |
|  |                             |  |
|  |  |-----------------------|  |  |
|     |                       |  |  |
|  |  |  |------- ---------|  |  |  |
|  |  |  |                 |     |  |
|  |  |  |-----------------|  |  |  |
|  |  |                       |  |  |
|  |  |-----------------------|  |  |
|  |                             |  |
|  |-----------------------------|  |
|                                   |
+-----------------------------------+